333333333333333333333333
322222222222222222222223
318111111111111111118113
3..........0...........3
3......................3
3......................3
3......................3
3......................3
3......................3
3......................3
3......................3
3......................3
3......................3
3.........P............3
333333333.....3333333333
333333333333333333333333
/