333333333333333333333333
333222222222222222222333
322111111111111111111223
311..................113
3.....5...T------......3
3.........-------......3
3.........-------......3
3.........-------......3
3.P.......-------....0.3
3......................3
3..................6...3
3..4...................3
3......................3
3......................3
333333333.....3333333333
333333333333333333333333
/