333333333333333333333333
322222222222222222222223
318111111111111111118113
3......................3
3...........5..........3
3...................6..3
3..4...................3
3.....................33
3.....................83
3....................0.3
3......................3
3......................3
3.P................7...3
3......................3
333333333333333333333333
333333333333333333333333
/room2