333333333333333333333333
333222222222222222222333
322111111111111111111223
311........0.........113
3....C..............C..3
3......................3
3....5..........6......3
3......................3
3..C...............C...3
3......................3
3......................3
3..4...............7...3
3......................3
3.........P............3
333333333.....3333333333
333333333333333333333333
/