333333333333333333333333
322222222222222222222223
318111111111111111118113
3......................3
3....C......5....C.....3
3...................6..3
3..4...................3
3........T------......33
3........-------......83
3........-------.....0.3
3........-------.......3
3........-------.......3
3.P................7...3
3.............C........3
333333333333333333333333
333333333333333333333333
/room2