111111111111111__111111111111111
1                              1
1              W               1
1                              1
1                              1
1       11111      11111       1
1       1              1       1
1       1              1       1
1       1              1       1
1       1              1       1
1                              1
_              11              _
_    W         11         W    _
1                              1
1       1              1       1
1       1              1       1
1       1              1       1
1       1              1       1
1       11111      11111       1
1                              1
1                              1
1      P                       1
1                              1
111111111111111__111111111111111
/room1

111111111111111__111111111111111
1                              1
1                              1
1                              1
1                              1
1                              1
1                              1
1                              1
1                              1
1                              1
1                              1
_                              _
_                              _
1                              1
1                              1
1                              1
1                              1
1                              1
1                              1
1                              1
1                              1
1                              1
1                              1
111111111111111__111111111111111
/room2

111111111111111__111111111111111
1                              1
1              W               1
1                              1
1                              1
1                              1
1       1              1       1
1       1              1       1
1       1              1       1
1       1              1       1
1                              1
1                              1
_    W                    W    _
_                              _
1       1              1       1
1       1              1       1
1       1              1       1
1       1              1       1
1                              1
1                              1
1                              1
1               W           W  1
1                              1
111111111111111__111111111111111
/room3