11111111111111111111111111111111
1..............................1
1....w.........................1
1..............................1
1..............................1
1.......11111......11111.......1
1.......1..............1.......1
1.......1..............1.......1
1.......1......W.......1.......1
1.......1..............1.......1
1..............................1
1..............11...........W..1
1..............11..............1
1..............................1
1.......1..............1.......1
1.......1..............1.......1
1.......1..............1.......1
1.......1..............1.......1
1.......11111......11111.......1
1..............................1
1.....W........................1
1..P............W..............1
1..............................1
11111111111111111111111111111111
