........................311111111111111111111113........................................................................
........................3EEEEEEEE..CC..EEEEEEEE3........................................................................
........................3SSSSSSSS......SSSSSSSS3........................................................................
........................3SSSSSSSSS....SSSSSSSSS3........................................................................
........................3cccSSSSSS....SSSSSSccc3........................................................................
........................3...ccSSSS....SSSScc...3........................................................................
........................3.....cccc....cccc.....3........................................................................
........................3......................3........................................................................
........................3......................3........................................................................
........................3......................3........................................................................
........................3...........7..........3........................................................................
........................3......................3........................................................................
........................3......................3........................................................................
........................3......................3........................................................................
........................3......................3........................................................................
........................33333333333--33333333333........................................................................
........................31111111111--11111111113311111111111111111111113........................311111111111111111111113
........................3......................33..........2222333333333........................3331.......CC.......1333
........................3......................33..........1111222233333........................3331................1333
........................3......................33..............111122223........................3331................1333
........................3......................33...................1113........................3331................1333
........................3............2222222222222222222222............3........................3331................1333
........................3............1111111111111111111111............3........................33311..............11333
........................3......................--......................3........................33331111........11113333
........................3......................--......................3........................33333321........12333333
........................3............2222222222332222222222............3........................3333321..........1233333
........................3............1111111111331111111111............3........................333321............123333
........................3......................33...................3333........................33321..............12333
........................3......................33................3333333........................3321................1233
........................3......................33............33333333333........................321..................123
........................3......................33............33333333333........................31....................13
........................33333333333333333333333333333333333--33333333333........................33333333333--33333333333
................................................31111111111--111111111133EEEEEumEEEE11111111111331111111111--11111111113
................................................3......................33SSSSS..SSSS...........3333333333......333333333
................................................3......................33Scccc..cccc..S..SSSS..3333333333......333333333
................................................3......................33S...............SScc..3322222222......222222223
................................................3......................33S..SSSSSSSSSSS..SS....3311111111......111111113
................................................3........SS..SS........22S.........SSSS..SSSS..22......................3
................................................3.......Sc....cS.......11ccccSSSS..SSSS..SSSS..11......................3
................................................3......SS......SS......--....SSSS..SSSSSSSSSS..--..........6...........3
................................................3......cS......Sc......--....SSSS..SSSSccccSS..--......................3
................................................3.......cS....Sc.......3333..SSSS..SSSS....SSSS33......................3
................................................3........cc..cc........3333..SSSS..SSSS..cccccc33......................3
................................................3......................3333..SSSS..SSSS........3333333333......333333333
................................................3......................3333..cccc..cccc..3333..3333333333......333333333
................................................3......................3333..............3333..3333333333......333333333
................................................3......................3333333333333333333333C.3333333333......333333333
................................................33333333333--33333333333333333333333333333333um3333333333333333333333333
33333333333333333333333331111111111111111111111331111111111--11111111113................................................
3EEEEEEEEEEEEEEEEEEEEEE33........33..W.........33......................3................................................
3SSSSSSSSSSSSSSSSSSSSSS33.....W..22..W..33..W..33......................3................................................
3cccccccccccccccccccccc33........11.....22.....33...23333......33332...3................................................
3.......4..............33....33.........11.W...33...12233......33221...3................................................
3......................22....22.W..............22....1122......2211....3................................................
3......................11....11.....33......W..11......11......11......3................................................
3.................Y....--.....W.W...22....W....--...........5..........3................................................
3..P...................--.....W.Y...11...33....--......................3................................................
3......................33.....W..........22....33......33......33......3................................................
3......................33......33........11....33....3333......3333....3................................................
3......................33......22...33...W..W..33...22222......22222...3................................................
3333333333333333333333333......11...22.........33...11111......11111...3................................................
3333333333333333333333333...........11...W.W...33......................3................................................
3333333333333333333333333.......W...W.W...W....33......................3................................................
33333333333333333333333333333333333333333333333333333333333--33333333333................................................
................................................31111111111--12233333333311111111111111111111113........................
................................................3ueeeeeeem....11222333333ueeeeeeeeeeeeeeeeeeeem3........................
................................................3vaaaaaaao......111223333vaaaaaaaaaaaaaaaaaaaao3........................
................................................3..................112333......................3........................
................................................3....................1233......................3........................
................................................3.....................122..........33..........3........................
................................................3......................11.........3333.........3........................
................................................3......................--........333333........3........................
................................................3......................--........333333........3........................
................................................33.....................33.........2222.........3........................
................................................333....................33S.........11.........S3........................
................................................33333..................33SS..................SS3........................
................................................3333333................333SS................SS33........................
................................................333333333..............3333SSSS333....333SSSS333........................
................................................33333333333............33333333333.CC.3333333333........................
................................................333333333333333333333333333333333333333333333333........................